{
    "width": 5,
    "height": 5,
    "tiles": [
        1, 1, 1, 1, 1,
        1, 0, 1, 0, 1,
        1, 1, 2, 1, 1,
        1, 0, 1, 0, 1,
        1, 1, 1, 1, 1
    ]
}
